Apa	./sequences/Apa.fasta	pep
Atr	./sequences/Atr.fasta	pep
Bma	./sequences/Bma.fasta	pep
Bmo	./sequences/Bmo.fasta	pep
Cpo	./sequences/Cpo.fasta	pep
Csa	./sequences/Csa.fasta	pep
Csu	./sequences/Csu.fasta	pep
Dar	./sequences/Dar.fasta	pep
Dpu	./sequences/Dpu.fasta	pep
Eja	./sequences/Eja.fasta	pep
Har	./sequences/Har.fasta	pep
Lac	./sequences/Lac.fasta	pep
Lde	./sequences/Lde.fasta	pep
Mse	./sequences/Mse.fasta	pep
Obr	./sequences/Obr.fasta	pep
Ofu	./sequences/Ofu.fasta	pep
Pin	./sequences/Pin.fasta	pep
Pra	./sequences/Pra.fasta	pep
Pxy	./sequences/Pxy.fasta	pep
Sfr	./sequences/Sfr.fasta	pep
Sri	./sequences/Sri.fasta	pep
Tab	./sequences/Tab.fasta	pep
Tmo	./sequences/Tmo.fasta	pep
Tni	./sequences/Tni.fasta	pep
